index,Team,Season,Country,Played Matches,Home Matches,Away Matches,Wins,Home Wins,Away Wins,Draws,Loses,Point Per Game,League Position,Rank,Goals Scored,Goals Conceded,Home Goals,Away Goals,Shots,Fouls,Goals Per Match,Goals Conceded Per Match,Corners Per Match,Cards Per Match
0,Borussia Dortmund,2011/2012,Germany,6,3,3,1,1,0,1,4,0.67,4,49,6,12,4,2,58,80,1,2,4.33,1.17
1,Bayern MÃ¼nchen,2011/2012,Germany,15,8,7,10,7,3,2,3,2.13,1,1,29,11,22,7,210,223,1.93,0.73,5.87,2
2,Bayer Leverkusen,2011/2012,Germany,8,4,4,3,3,0,1,4,1.25,2,22,10,18,7,3,76,108,1.25,2.25,4.75,2.5
3,Olympique Lyonnais,2011/2012,France,10,5,5,4,3,1,3,3,1.5,2,10,14,10,6,8,169,148,1.4,1,6.2,1.7
4,Arsenal,2011/2012,England,10,5,5,6,4,2,2,2,2,1,8,13,11,8,5,96,120,1.3,1.1,4,2.3
5,Napoli,2011/2012,Italy,8,4,4,4,3,1,2,2,1.75,2,11,14,11,8,6,86,120,1.75,1.38,6,2.63
6,Villarreal,2011/2012,Spain,8,4,4,1,1,0,0,7,0.38,4,55,5,15,3,2,99,116,0.63,1.88,6.13,3.88
7,FC Barcelona,2011/2012,Spain,12,6,6,8,4,4,3,1,2.25,1,3,35,10,20,15,210,105,2.92,0.83,5.92,1.42
8,Real Madrid,2011/2012,Spain,12,6,6,10,6,4,1,1,2.58,1,2,35,9,24,11,176,127,2.92,0.75,5.36,2.18
9,Manchester City,2011/2012,England,6,3,3,3,2,1,1,2,1.67,3,21,9,6,5,4,91,73,1.5,1,4.33,1.67
10,Manchester United,2011/2012,England,6,3,3,2,1,1,3,1,1.5,3,24,11,8,7,4,83,70,1.83,1.33,4.67,1.67
11,Chelsea,2011/2012,England,13,6,7,7,6,1,4,2,1.92,1,4,25,12,17,8,175,171,1.92,0.92,3.85,2.54
12,Valencia CF,2011/2012,Spain,6,3,3,2,2,0,2,2,1.33,3,27,12,7,11,1,87,73,2,1.17,5.67,1.83
13,Lille,2011/2012,France,6,3,3,1,0,1,3,2,1,4,40,6,6,2,4,92,94,1,1,8.83,2.5
14,Olympique Marseille,2011/2012,France,10,5,5,4,2,2,1,5,1.3,2,16,9,10,4,5,107,131,0.9,1,4.3,2.5
15,AC Milan,2011/2012,Italy,10,5,5,3,3,0,4,3,1.3,2,14,16,14,10,6,125,137,1.6,1.4,3.2,2.5
16,Udinese,2011/2012,Italy,2,1,1,0,0,0,0,2,0,0,65,1,3,1,0,26,27,0.5,1.5,5,3
17,Inter Milan,2011/2012,Italy,8,4,4,4,2,2,1,3,1.63,1,15,10,9,5,5,77,116,1.25,1.13,4.13,2
18,Bangor City,2011/2012,Wales,2,1,1,0,0,0,0,2,0,0,75,0,13,0,0,0,0,0,6.5,0,1.5
19,Borussia Dortmund,2014/2015,Germany,8,4,4,4,2,2,1,3,1.63,16,14,15,9,7,8,103,64,1.88,1.13,5.38,0.5
20,Schalke 04,2014/2015,Germany,8,4,4,3,1,2,2,3,1.38,10,19,13,19,5,8,83,92,1.63,2.38,4.75,1.38
21,Bayern MÃ¼nchen,2014/2015,Germany,12,6,6,8,6,2,1,3,2.08,3,4,33,13,22,11,146,154,2.75,1.08,5.75,2.33
22,Bayer Leverkusen,2014/2015,Germany,10,5,5,6,4,2,1,3,1.9,9,7,15,7,10,5,116,179,1.5,0.7,4.3,2.7
23,Monaco,2014/2015,Monaco,10,5,5,4,2,2,3,3,1.5,7,11,7,5,3,4,87,140,0.7,0.5,4.1,2.2
24,Arsenal,2014/2015,England,10,5,5,6,3,3,2,2,2,6,6,19,11,11,8,95,125,1.9,1.1,4.9,2.4
25,PSG,2014/2015,France,10,5,5,4,3,1,3,3,1.5,8,12,14,15,9,5,101,121,1.4,1.5,5.1,1.6
26,The New Saints,2014/2015,Wales,1,1,0,0,0,0,0,1,0,26,69,0,2,0,0,6,14,0,2,1,2
27,Napoli,2014/2015,Italy,2,1,1,0,0,0,1,1,0.5,15,60,2,4,1,1,16,22,1,2,4.5,2
28,FC Barcelona,2014/2015,Spain,13,6,7,11,6,5,0,2,2.54,1,1,31,11,13,18,151,131,2.38,0.85,4.77,1.54
29,Real Madrid,2014/2015,Spain,12,6,6,8,4,4,2,2,2.17,4,3,24,9,15,9,164,105,2,0.75,7,1.75
30,Juventus,2014/2015,Italy,13,7,6,7,5,2,3,3,1.85,2,5,17,10,11,6,137,172,1.31,0.77,4.92,1.92
31,Manchester City,2014/2015,England,8,4,4,2,1,1,2,4,1,15,28,10,11,6,4,76,105,1.25,1.38,5.5,3.13
32,Roma,2014/2015,Italy,6,3,3,1,1,0,2,3,0.83,25,45,8,14,6,2,48,57,1.33,2.33,3.33,1
33,AtlÃ©tico Madrid,2014/2015,Spain,10,5,5,5,4,1,2,3,1.7,6,8,15,5,11,4,95,137,1.5,0.5,6.4,3.2
34,Liverpool,2014/2015,England,6,3,3,1,1,0,2,3,0.83,23,43,5,9,3,2,60,83,0.83,1.5,3.83,1.67
35,Chelsea,2014/2015,England,8,4,4,4,2,2,4,0,2,11,9,20,6,12,8,85,113,2.5,0.75,6.13,1.63
36,Athletic Club Bilbao,2014/2015,Spain,8,4,4,3,2,1,2,3,1.38,19,18,9,8,5,4,88,119,1.13,1,4.63,2.5
37,Lille,2014/2015,France,4,2,2,1,0,1,1,2,1,18,48,3,4,1,2,31,57,0.75,1,3.25,2.25
38,Borussia Dortmund,2012/2013,Germany,13,7,6,7,6,1,4,2,1.92,1,2,24,14,15,9,185,156,1.85,1.08,4.77,1.08
39,Schalke 04,2012/2013,Germany,8,4,4,3,1,2,4,1,1.63,1,18,13,10,7,6,134,110,1.63,1.25,6.25,2.13
40,Bayern MÃ¼nchen,2012/2013,Germany,13,6,7,10,5,5,1,2,2.38,1,1,31,11,18,13,215,173,2.38,0.85,8.31,2.46
41,Borussia M'gladbach,2012/2013,Germany,2,1,1,1,0,1,0,1,1.5,0,49,3,4,1,2,35,26,1.5,2,4.5,1.5
42,Arsenal,2012/2013,England,8,4,4,4,2,2,1,3,1.63,2,19,13,11,6,7,71,123,1.63,1.38,3.75,3.25
43,PSG,2012/2013,France,10,5,5,6,3,3,3,1,2.1,1,5,20,8,13,7,134,132,2,0.8,4.5,2.4
44,The New Saints,2012/2013,Wales,2,1,1,0,0,0,1,1,0.5,0,67,0,3,0,0,0,0,0,1.5,0,1.5
45,FC Barcelona,2012/2013,Spain,12,6,6,5,3,2,3,4,1.5,1,9,18,17,10,8,187,110,1.5,1.42,6.08,2.25
46,Real Madrid,2012/2013,Spain,12,6,6,6,4,2,3,3,1.75,2,6,26,18,15,11,230,150,2.17,1.5,5.92,2.08
47,Juventus,2012/2013,Italy,10,5,5,5,3,2,3,2,1.8,1,8,17,8,10,7,162,146,1.7,0.8,6.3,2
48,Manchester City,2012/2013,England,6,3,3,0,0,0,3,3,0.5,4,54,7,11,4,3,70,74,1.17,1.83,5.33,2.5
49,Manchester United,2012/2013,England,8,4,4,4,2,2,1,3,1.63,1,20,11,9,5,6,124,92,1.38,1.13,6.75,1.75
50,Chelsea,2012/2013,England,6,3,3,3,2,1,1,2,1.67,2,24,16,10,11,5,97,66,2.67,1.67,7,1
51,MÃ¡laga CF,2012/2013,Spain,12,6,6,5,4,1,5,2,1.67,1,7,18,9,10,8,142,164,1.5,0.75,4.42,2.42
52,Valencia CF,2012/2013,Spain,8,4,4,4,2,2,2,2,1.75,2,15,14,8,8,6,83,128,1.75,1,4.25,2.88
53,Montpellier,2012/2013,France,6,3,3,0,0,0,2,4,0.33,4,58,6,12,3,3,85,75,1,2,4,2.83
54,Lille,2012/2013,France,8,4,4,2,1,1,0,6,0.75,4,39,6,14,3,3,130,137,0.75,1.75,5.5,3
55,AC Milan,2012/2013,Italy,8,4,4,3,1,2,2,3,1.38,2,23,9,10,3,6,109,112,1.13,1.25,4.38,2.63
56,Udinese,2012/2013,Italy,2,1,1,0,0,0,2,0,1,0,56,2,2,1,1,17,46,1,1,3.5,3.5
57,Borussia Dortmund,2013/2014,Germany,10,5,5,6,3,3,0,4,1.8,6,10,18,13,9,9,113,148,1.8,1.3,5.3,2.1
58,Schalke 04,2013/2014,Germany,10,5,5,4,2,2,2,4,1.4,16,17,12,18,7,5,110,132,1.2,1.8,4.8,2.2
59,Bayern MÃ¼nchen,2013/2014,Germany,12,6,6,7,3,4,2,3,1.92,4,3,24,13,14,10,210,133,2,1.08,8.17,1.42
60,Bayer Leverkusen,2013/2014,Germany,8,4,4,3,2,1,1,4,1.25,15,24,10,16,6,4,105,98,1.25,2,5.63,2.88
61,Olympique Lyonnais,2013/2014,France,4,2,2,2,1,1,0,2,1.5,18,39,2,4,1,1,38,51,0.5,1,6,1.75
62,Arsenal,2013/2014,England,10,5,5,6,3,3,1,3,1.9,11,8,14,8,7,7,82,112,1.4,0.8,3.7,1.8
63,PSG,2013/2014,France,10,5,5,7,4,3,1,2,2.2,5,4,25,9,11,14,104,112,2.5,0.9,3.8,2.1
64,The New Saints,2013/2014,Wales,2,1,1,0,0,0,0,2,0,28,66,1,4,1,0,13,23,0.5,2,2,2
65,Napoli,2013/2014,Italy,6,3,3,4,3,1,0,2,2,11,20,10,9,7,3,74,82,1.67,1.5,3.83,1.83
66,FC Barcelona,2013/2014,Spain,10,5,5,6,4,2,2,2,2,7,6,21,8,16,5,130,107,2.1,0.8,7,2
67,Real Madrid,2013/2014,Spain,13,7,6,11,7,4,1,1,2.62,1,1,41,10,21,20,186,123,3.15,0.77,4.77,2
68,Juventus,2013/2014,Italy,6,3,3,1,1,0,3,2,1,21,37,9,9,7,2,117,70,1.5,1.5,8,1.83
69,Manchester City,2013/2014,England,8,4,4,5,2,3,0,3,1.88,13,15,19,14,10,9,102,121,2.38,1.75,4,3.13
70,AtlÃ©tico Madrid,2013/2014,Spain,13,6,7,9,5,4,3,1,2.31,2,2,26,10,14,12,157,207,2,0.77,5.23,2.62
71,Manchester United,2013/2014,England,10,5,5,5,4,1,3,2,1.8,8,9,17,9,10,7,109,129,1.7,0.9,5.2,1.8
72,Chelsea,2013/2014,England,12,6,6,6,4,2,2,4,1.67,3,7,19,10,10,9,133,174,1.58,0.83,4.92,2.08
73,Real Sociedad,2013/2014,Spain,8,4,4,2,1,1,1,5,0.88,30,36,5,10,2,3,105,98,0.63,1.25,6,2.13
74,Olympique Marseille,2013/2014,France,6,3,3,0,0,0,0,6,0,32,75,5,14,3,2,63,68,0.83,2.33,2.5,2.5
75,AC Milan,2013/2014,Italy,10,5,5,3,2,1,4,3,1.3,14,18,13,11,6,7,92,127,1.3,1.1,3.6,2.6
76,Bayern MÃ¼nchen,2015/2016,Germany,12,6,6,8,6,2,2,2,2.17,3,2,30,11,21,9,198,136,2.5,0.92,7.33,1.83
77,Borussia M'gladbach,2015/2016,Germany,6,3,3,1,1,0,2,3,0.83,23,45,8,12,6,2,65,63,1.33,2,4,1.83
78,Bayer Leverkusen,2015/2016,Germany,8,4,4,2,2,0,3,3,1.13,19,26,16,13,12,4,100,116,2,1.63,4.25,2.63
79,Wolfsburg,2015/2016,Germany,10,5,5,7,5,2,0,3,2.1,6,6,15,11,9,6,105,99,1.5,1.1,3.7,1.8
80,Monaco,2015/2016,Monaco,4,2,2,3,2,1,0,1,2.25,12,25,10,5,6,4,42,62,2.5,1.25,8.25,2.25
81,Olympique Lyonnais,2015/2016,France,6,3,3,1,0,1,1,4,0.67,27,50,5,9,1,4,89,95,0.83,1.5,6.83,2.5
82,Arsenal,2015/2016,England,8,4,4,3,2,1,0,5,1.13,15,28,13,15,7,6,85,83,1.63,1.88,5.63,2.13
83,PSG,2015/2016,France,10,5,5,6,3,3,2,2,2,8,7,18,6,8,10,108,116,1.8,0.6,5.7,2.2
84,The New Saints,2015/2016,Wales,4,2,2,2,1,1,1,1,1.75,25,34,7,4,4,3,25,36,1.75,1,2,2
85,FC Barcelona,2015/2016,Spain,10,5,5,7,5,2,2,1,2.3,5,3,22,8,16,6,124,104,2.2,0.8,6,2.3
86,Real Madrid,2015/2016,Spain,13,7,6,9,6,3,3,1,2.31,2,1,28,6,20,8,195,134,2.15,0.46,6.77,1.85
87,Juventus,2015/2016,Italy,8,4,4,3,2,1,3,2,1.5,10,19,10,9,5,5,99,96,1.25,1.13,4.25,2
88,Manchester City,2015/2016,England,12,6,6,6,3,3,3,3,1.75,4,5,18,12,8,10,130,149,1.5,1,5.08,1.25
89,Sevilla FC,2015/2016,Spain,6,3,3,2,2,0,0,4,1,20,37,8,11,5,3,64,59,1.33,1.83,6.33,1.17
90,Roma,2015/2016,Italy,8,4,4,1,1,0,3,4,0.75,16,38,11,20,4,7,91,86,1.38,2.5,5.13,1.25
91,AtlÃ©tico Madrid,2015/2016,Spain,13,6,7,6,4,2,4,3,1.69,1,4,17,8,10,7,162,147,1.31,0.62,6.31,1.77
92,Manchester United,2015/2016,England,8,4,4,4,3,1,2,2,1.75,18,13,14,8,6,8,92,88,1.75,1,6.38,1.75
93,Chelsea,2015/2016,England,8,4,4,4,3,1,1,3,1.63,12,14,15,7,9,6,88,109,1.88,0.88,5.25,1.88
94,Valencia CF,2015/2016,Spain,8,4,4,3,2,1,0,5,1.13,21,30,9,12,7,2,80,115,1.13,1.5,7.75,3.25
95,Lazio,2015/2016,Italy,2,1,1,1,1,0,0,1,1.5,14,57,1,3,1,0,13,23,0.5,1.5,3.5,3
96,Borussia Dortmund,2017/2018,Germany,6,3,3,0,0,0,2,4,0.33,3,60,7,13,3,4,61,53,1.17,2.17,7.67,1.67
97,Bayern MÃ¼nchen,2017/2018,Germany,12,6,6,8,4,4,2,2,2.17,2,3,26,12,15,11,197,139,2.17,1,8.25,1.92
98,RB Leipzig,2017/2018,Germany,6,3,3,2,1,1,1,3,1.17,3,35,10,11,5,5,70,87,1.67,1.83,6.33,1.83
99,Hoffenheim,2017/2018,Germany,2,1,1,0,0,0,0,2,0,0,73,3,6,1,2,19,26,1.5,3,5,3
100,Monaco,2017/2018,Monaco,6,3,3,0,0,0,2,4,0.33,4,61,6,16,2,4,55,87,1,2.67,5,2.67
101,PSG,2017/2018,France,8,4,4,5,3,2,0,3,1.88,1,14,27,9,16,11,112,82,3.38,1.13,4.13,1.63
102,The New Saints,2017/2018,Wales,4,2,2,1,0,1,0,3,0.75,0,55,5,10,2,3,26,38,1.25,2.5,3.75,2.25
103,Napoli,2017/2018,Italy,8,4,4,4,3,1,0,4,1.5,3,21,15,11,10,5,103,91,1.88,1.38,6.5,1.88
104,FC Barcelona,2017/2018,Spain,10,5,5,6,5,1,3,1,2.1,1,4,17,6,15,2,112,102,1.7,0.6,5.8,1.9
105,Real Madrid,2017/2018,Spain,13,7,6,9,4,5,2,2,2.23,2,2,33,16,16,17,198,129,2.54,1.23,7.62,1.62
106,Juventus,2017/2018,Italy,10,5,5,5,2,3,3,2,1.8,2,8,14,12,6,8,111,143,1.4,1.2,5.5,2.9
107,Tottenham Hotspur,2017/2018,England,8,4,4,5,3,2,2,1,2.13,1,10,18,8,10,8,101,116,2.25,1,5.88,1.63
108,Manchester City,2017/2018,England,10,5,5,6,3,3,0,4,1.8,1,7,20,12,7,13,119,92,2,1.2,6,1.9
109,Sevilla FC,2017/2018,Spain,12,6,6,4,2,2,6,2,1.5,2,9,19,18,11,8,159,126,1.58,1.5,7,2.17
110,Roma,2017/2018,Italy,12,6,6,6,5,1,2,4,1.67,2,6,21,19,12,9,166,114,1.75,1.58,6.08,1.42
111,AtlÃ©tico Madrid,2017/2018,Spain,6,3,3,1,1,0,4,1,1.17,3,33,5,4,4,1,86,78,0.83,0.67,6,1.17
112,Manchester United,2017/2018,England,8,4,4,5,3,2,1,2,2,1,11,13,5,8,5,96,97,1.63,0.63,6.38,1.25
113,Liverpool,2017/2018,England,15,7,8,9,5,4,4,2,2.07,1,1,47,19,24,23,218,171,3.13,1.27,5.27,1.67
114,Chelsea,2017/2018,England,8,4,4,3,1,2,3,2,1.5,1,20,17,12,11,6,106,95,2.13,1.5,4.88,1.25
115,Nice,2017/2018,France,4,2,2,0,0,0,2,2,0.5,0,59,3,7,1,2,34,46,0.75,1.75,3.5,2.75
116,Borussia Dortmund,2016/2017,Germany,10,5,5,5,3,2,2,3,1.7,1,9,28,16,17,11,147,105,2.8,1.6,5.1,1.9
117,Bayern MÃ¼nchen,2016/2017,Germany,10,5,5,6,4,2,0,4,1.8,2,7,27,14,16,11,183,116,2.7,1.4,6.5,2
118,Borussia M'gladbach,2016/2017,Germany,8,4,4,3,1,2,2,3,1.38,3,23,14,14,9,5,59,75,1.75,1.75,3.25,1.75
119,Bayer Leverkusen,2016/2017,Germany,8,4,4,2,1,1,5,1,1.38,2,21,10,8,7,3,101,94,1.25,1,5.25,2
120,Monaco,2016/2017,Monaco,16,8,8,9,6,3,2,5,1.81,1,3,29,24,16,13,173,197,1.81,1.5,4.44,2.44
121,Olympique Lyonnais,2016/2017,France,6,3,3,2,1,1,2,2,1.33,3,27,5,3,3,2,106,86,0.83,0.5,6.67,2.33
122,Arsenal,2016/2017,England,8,4,4,4,2,2,2,2,1.75,1,16,20,16,11,9,86,95,2.5,2,4.75,2.13
123,PSG,2016/2017,France,8,4,4,4,2,2,3,1,1.88,2,15,18,13,10,8,120,96,2.25,1.63,7.38,2.13
124,The New Saints,2016/2017,Wales,4,2,2,2,1,1,1,1,1.75,0,28,5,4,2,3,44,39,1.25,1,5.25,1.5
125,Napoli,2016/2017,Italy,8,4,4,3,1,2,2,3,1.38,1,24,13,14,7,6,90,106,1.63,1.75,8.25,1.25
126,Villarreal,2016/2017,Spain,2,1,1,0,0,0,0,2,0,0,73,1,3,1,0,17,22,0.5,1.5,4,1
127,FC Barcelona,2016/2017,Spain,10,5,5,6,4,2,1,3,1.9,1,6,26,12,21,5,113,123,2.6,1.2,6.5,2.7
128,Real Madrid,2016/2017,Spain,13,6,7,9,5,4,3,1,2.31,2,1,36,18,19,17,242,118,2.77,1.38,5.54,1.46
129,Juventus,2016/2017,Italy,13,7,6,9,4,5,3,1,2.31,1,2,22,7,10,12,185,181,1.69,0.54,4.54,2.38
130,Tottenham Hotspur,2016/2017,England,6,3,3,2,1,1,1,3,1.17,3,30,6,6,4,2,79,66,1,1,7.67,1
131,Manchester City,2016/2017,England,10,5,5,5,4,1,3,2,1.8,2,8,24,16,14,10,118,117,2.4,1.6,6,2
132,Sevilla FC,2016/2017,Spain,8,4,4,4,3,1,2,2,1.75,2,17,9,6,8,1,105,94,1.13,0.75,5.75,2.38
133,Leicester City,2016/2017,England,10,5,5,5,4,1,2,3,1.7,1,10,11,10,7,4,89,113,1.1,1,3.6,1.9
134,Roma,2016/2017,Italy,2,1,1,0,0,0,1,1,0.5,0,70,1,4,0,1,31,25,0.5,2,7,5.5
135,AtlÃ©tico Madrid,2016/2017,Spain,12,6,6,8,5,3,2,2,2.17,1,4,15,9,8,7,151,120,1.25,0.75,5.33,1.75
136,Borussia Dortmund,2019/2020,Germany,8,4,4,4,3,1,1,3,1.63,2,18,10,11,7,3,110,92,1.25,1.38,3,2
137,Bayern MÃ¼nchen,2019/2020,Germany,11,4,7,11,4,7,0,0,3,1,1,43,8,12,31,249,133,3.91,0.73,8.18,1.18
138,Bayer Leverkusen,2019/2020,Germany,6,3,3,2,1,1,0,4,1,3,40,5,9,3,2,91,92,0.83,1.5,7,1.5
139,RB Leipzig,2019/2020,Germany,10,6,4,6,3,3,2,2,2,1,5,16,12,9,7,165,150,1.6,1.2,5.9,2
140,Olympique Lyonnais,2019/2020,France,10,5,5,4,2,2,2,4,1.4,2,12,14,14,7,7,133,124,1.4,1.4,5.1,2.2
141,PSG,2019/2020,France,11,5,6,8,4,4,1,2,2.27,1,2,25,6,11,14,134,138,2.27,0.55,4.36,2.64
142,The New Saints,2019/2020,Wales,4,2,2,1,0,1,1,2,1,0,42,3,5,2,1,21,36,0.75,1.25,2,1.5
143,Napoli,2019/2020,Italy,8,4,4,3,2,1,4,1,1.63,2,15,13,8,8,5,110,78,1.63,1,4.63,1.75
144,FC Barcelona,2019/2020,Spain,9,5,4,5,3,2,3,1,2,1,9,15,14,10,5,111,104,1.67,1.56,3.89,2.78
145,Real Madrid,2019/2020,Spain,8,4,4,3,1,2,2,3,1.38,2,20,16,12,11,5,142,69,2,1.5,5.38,1.88
146,Juventus,2019/2020,Italy,8,4,4,6,4,2,1,1,2.38,1,7,14,6,8,6,115,85,1.75,0.75,4.88,1.25
147,Tottenham Hotspur,2019/2020,England,8,4,4,3,2,1,1,4,1.25,2,27,18,18,11,7,106,96,2.25,2.25,4,1.75
148,Manchester City,2019/2020,England,9,5,4,6,3,3,2,1,2.22,1,3,21,9,11,10,158,101,2.33,1,7,1.89
149,AtlÃ©tico Madrid,2019/2020,Spain,9,4,5,5,3,2,1,3,1.78,2,11,13,9,6,7,123,111,1.44,1,5.11,1.78
150,Liverpool,2019/2020,England,8,4,4,4,2,2,1,3,1.63,1,16,15,12,9,6,148,91,1.88,1.5,8.13,1.13
151,Chelsea,2019/2020,England,8,4,4,3,1,2,2,3,1.38,1,25,12,16,6,6,135,102,1.5,2,6.13,2
152,Valencia CF,2019/2020,Spain,8,4,4,3,1,2,2,3,1.38,2,24,13,15,9,4,107,76,1.63,1.88,4.38,2.63
153,Lille,2019/2020,France,6,3,3,0,0,0,1,5,0.17,4,71,4,14,2,2,91,84,0.67,2.33,5,2.33
154,Atalanta,2019/2020,Italy,9,5,4,4,2,2,1,4,1.44,2,17,17,18,9,8,127,148,1.89,2,4.11,2.78
155,Inter Milan,2019/2020,Italy,6,3,3,2,1,1,1,3,1.17,3,33,10,9,4,6,77,78,1.67,1.5,2,2.83
156,Borussia Dortmund,2018/2019,Germany,8,4,4,4,2,2,1,3,1.63,1,14,10,6,7,3,80,58,1.25,0.75,5,1.38
157,Schalke 04,2018/2019,Germany,8,4,4,3,2,1,2,3,1.38,2,22,8,14,6,2,65,103,1,1.75,4.25,2.13
158,Bayern MÃ¼nchen,2018/2019,Germany,8,4,4,4,2,2,3,1,1.88,1,10,16,8,9,7,95,87,2,1,6.13,1.75
159,Hoffenheim,2018/2019,Germany,6,3,3,0,0,0,3,3,0.5,4,54,11,14,6,5,77,82,1.83,2.33,6,2.5
160,Monaco,2018/2019,Monaco,6,3,3,0,0,0,1,5,0.17,4,69,2,14,1,1,56,68,0.33,2.33,3.67,2.17
161,Olympique Lyonnais,2018/2019,France,8,4,4,1,0,1,6,1,1.13,2,27,13,16,6,7,94,83,1.63,2,3.25,1.63
162,PSG,2018/2019,France,8,4,4,4,2,2,2,2,1.75,1,13,20,12,11,9,103,84,2.5,1.5,5.13,2.25
163,The New Saints,2018/2019,Wales,2,1,1,1,1,0,0,1,1.5,0,49,4,5,4,0,21,19,2,2.5,5,2.5
164,Napoli,2018/2019,Italy,6,3,3,2,2,0,3,1,1.5,3,26,7,5,5,2,82,68,1.17,0.83,5.5,2.17
165,FC Barcelona,2018/2019,Spain,12,6,6,8,5,3,3,1,2.25,1,2,26,10,18,8,170,122,2.17,0.83,5.58,1.75
166,Real Madrid,2018/2019,Spain,8,4,4,5,2,3,0,3,1.88,1,11,15,10,6,9,131,80,1.88,1.25,8.63,1.75
167,Juventus,2018/2019,Italy,10,5,5,5,3,2,1,4,1.6,1,8,14,9,9,5,130,126,1.4,0.9,5.3,1.8
168,Tottenham Hotspur,2018/2019,England,13,7,6,6,4,2,2,5,1.54,2,5,20,19,9,11,155,165,1.54,1.46,6.15,1.92
169,Manchester City,2018/2019,England,10,5,5,7,4,3,1,2,2.2,1,4,30,12,20,10,149,119,3,1.2,5.8,1.6
170,Roma,2018/2019,Italy,8,4,4,4,3,1,0,4,1.5,2,17,14,12,10,4,113,100,1.75,1.5,6.13,1.63
171,AtlÃ©tico Madrid,2018/2019,Spain,8,4,4,5,4,1,1,2,2,2,9,11,9,9,2,78,92,1.38,1.13,6,3
172,Manchester United,2018/2019,England,10,5,5,4,1,3,1,5,1.3,2,15,10,11,1,9,91,156,1,1.1,3.8,2.1
173,Liverpool,2018/2019,England,13,6,7,8,5,3,1,4,1.92,2,3,24,12,14,10,154,157,1.85,0.92,5.77,1.62
174,Valencia CF,2018/2019,Spain,6,3,3,2,2,0,2,2,1.33,3,30,6,6,5,1,55,81,1,1,3.67,3.33
175,Inter Milan,2018/2019,Italy,6,3,3,2,1,1,2,2,1.33,3,31,6,7,4,2,68,83,1,1.17,5.33,2.5
176,Borussia Dortmund,2020/2021,Germany,6,3,3,4,2,2,1,1,2.17,1,6,12,5,6,6,93,56,2,0.83,5.83,0.17
177,Bayern MÃ¼nchen,2020/2021,Germany,6,3,3,5,3,2,1,0,2.67,1,1,18,5,9,9,105,77,3,0.83,4.83,1.83
178,Borussia M'gladbach,2020/2021,Germany,6,3,3,2,1,1,2,2,1.33,2,24,16,9,8,8,77,90,2.67,1.5,2.83,1.83
179,RB Leipzig,2020/2021,Germany,6,3,3,4,3,1,0,2,2,2,12,11,12,7,4,89,110,1.83,2,4.67,2.67
180,PSG,2020/2021,France,6,3,3,4,2,2,0,2,2,1,11,13,6,7,6,87,63,2.17,1,5.17,2.83
181,FC Barcelona,2020/2021,Spain,6,3,3,5,2,3,0,1,2.5,1,3,16,5,7,9,116,64,2.67,0.83,5,1.83
182,Real Madrid,2020/2021,Spain,6,3,3,3,2,1,1,2,1.67,1,18,11,9,7,4,99,65,1.83,1.5,7.33,1.33
183,Juventus,2020/2021,Italy,6,3,3,5,2,3,0,1,2.5,2,4,14,4,5,9,87,82,2.33,0.67,3.67,2.33
184,Manchester City,2020/2021,England,6,3,3,5,3,2,1,0,2.67,1,2,13,1,9,4,97,51,2.17,0.17,6.17,1.67
185,Sevilla FC,2020/2021,Spain,6,3,3,4,2,2,1,1,2.17,2,9,9,8,4,5,107,65,1.5,1.33,5,2.5
186,AtlÃ©tico Madrid,2020/2021,Spain,6,3,3,2,1,1,3,1,1.5,2,23,7,8,4,3,87,72,1.17,1.33,7.83,1.83
187,Manchester United,2020/2021,England,6,3,3,3,2,1,0,3,1.5,3,21,15,10,10,5,94,84,2.5,1.67,5.67,2.17
188,Liverpool,2020/2021,England,6,3,3,4,2,2,1,1,2.17,1,7,10,3,3,7,73,74,1.67,0.5,4,1.67
189,Chelsea,2020/2021,England,6,3,3,4,1,3,2,0,2.33,1,5,14,2,4,10,75,83,2.33,0.33,4,2
190,Rennes,2020/2021,France,6,3,3,0,0,0,1,5,0.17,4,57,3,11,3,0,79,103,0.5,1.83,5.67,2.83
191,Olympique Marseille,2020/2021,France,6,3,3,1,1,0,0,5,0.5,4,52,2,13,2,0,51,67,0.33,2.17,3.67,2.5
192,Lazio,2020/2021,Italy,6,3,3,2,2,0,4,0,1.67,2,17,11,7,8,3,75,55,1.83,1.17,4.33,2.33
193,Atalanta,2020/2021,Italy,6,3,3,3,0,3,2,1,1.83,2,15,10,8,3,7,87,74,1.67,1.33,4.67,1.5
194,Inter Milan,2020/2021,Italy,6,3,3,1,0,1,3,2,1,4,35,7,9,2,5,81,79,1.17,1.5,5.17,3.67
195,Connah's Quay,2020/2021,Wales,1,1,0,0,0,0,0,1,0,0,66,0,2,0,0,4,14,0,2,2,1
196,Schalke 04,2010/2011,Germany,12,6,6,7,5,2,2,3,1.92,1,4,22,14,13,9,147,198,1.83,1.17,5.83,2.58
197,Werder Bremen,2010/2011,Germany,8,4,4,2,2,0,2,4,1,4,29,11,16,8,3,132,147,1.38,2,6.75,1.88
198,Bayern MÃ¼nchen,2010/2011,Germany,8,4,4,6,3,3,0,2,2.25,1,7,19,9,10,9,142,104,2.38,1.13,6.88,2.13
199,Olympique Lyonnais,2010/2011,France,8,4,4,3,2,1,2,3,1.38,2,22,12,14,6,6,133,108,1.5,1.75,7.13,1.88
200,Arsenal,2010/2011,England,8,4,4,5,4,1,0,3,1.88,2,13,21,11,16,5,93,132,2.63,1.38,3.25,2.25
201,The New Saints,2010/2011,Wales,4,2,2,1,1,0,0,3,0.75,0,53,5,7,5,0,17,31,1.25,1.75,3,0.75
202,FC Barcelona,2010/2011,Spain,13,7,6,9,6,3,3,1,2.31,1,1,30,9,21,9,235,140,2.31,0.69,4.69,1.23
203,Real Madrid,2010/2011,Spain,12,6,6,8,5,3,3,1,2.25,1,3,25,6,15,10,202,172,2.08,0.5,5.83,2.83
204,Tottenham Hotspur,2010/2011,England,12,6,6,5,4,1,3,4,1.5,1,8,25,19,14,11,150,155,2.08,1.58,4.08,1.58
205,Sevilla FC,2010/2011,Spain,2,1,1,0,0,0,0,2,0,0,68,3,5,3,0,41,30,1.5,2.5,4.5,3
206,Roma,2010/2011,Italy,8,4,4,3,2,1,1,4,1.25,2,23,12,17,8,4,124,110,1.5,2.13,5.75,2
207,Manchester United,2010/2011,England,13,6,7,9,4,5,3,1,2.31,1,2,19,7,10,9,165,170,1.46,0.54,5.77,1.08
208,Chelsea,2010/2011,England,10,5,5,6,3,3,1,3,1.9,1,6,17,7,8,9,188,135,1.7,0.7,5.2,1.6
209,Valencia CF,2010/2011,Spain,8,4,4,3,2,1,3,2,1.5,2,20,17,8,10,7,158,111,2.13,1,6.88,1.5
210,Olympique Marseille,2010/2011,France,8,4,4,4,2,2,1,3,1.63,2,15,13,5,2,11,135,108,1.63,0.63,5.63,1.38
211,AC Milan,2010/2011,Italy,8,4,4,2,1,1,3,3,1.13,2,25,7,8,4,3,88,118,0.88,1,4.88,2.88
212,Sampdoria,2010/2011,Italy,2,1,1,1,1,0,0,1,1.5,0,50,4,5,3,1,18,46,2,2.5,4,4
213,Inter Milan,2010/2011,Italy,10,5,5,4,3,1,1,5,1.3,2,17,18,21,11,7,161,98,1.8,2.1,5,2
214,Auxerre,2010/2011,France,8,4,4,2,2,0,0,6,0.75,4,42,5,13,4,1,98,103,0.63,1.63,3.75,2.13
